อุบลราชธานี - ก๋วยจั๊บญวณ
เชียงราย - ข้าวแรมฟืน / ไส้อั่ว
เชียงใหม่ - ข้าวซอย / พริกหนุ่ม
น่าน - ไก่ทอดมะแขว่น
พะเยา - แอ่งแถะ
แพร่ - ขนมจีนน้ำย้อย น้ำเงี้ยว
แม่ฮ่องสอน - ข้าวกั้นจิ้น
ลำปาง - แกงโฮะ / ข้าวแต๋น
ลำพูน - แกงฮังเล
อุตรดิตถ์ - ข้าวแคบ
นครราชสีมา - ไก่กะเต็ด
ศรีสะเกษ - วุ้นหมาน้อย
ชัยภูมิ - หม่ำ
ขอนแก่น - ปลาช่อนกระบอกเผา
บุรีรัมย์ - ลูกชิ้นยืนกิน
ยโสธร - ข้าวปุ้นน้ำงัว
ร้อยเอ็ด - ปุ้นคลุก
เลย - ตำด๊องเด๊ง
สกลนคร - ไก่ย่างพังโคน
นครพนม - ปลาเอินต้มเค็ม
มุกดาหาร - สลัดญวน
หนองคาย - ข้าวโซย 
อุดรธานี - ไก่ตุ๊ป่อง
บึงกาฬ - ลาบปลาเผาะ
สุรินทร์ - อังแก๊บบอบ
หนองบัวลำภู - ปลาส้มทอด
อำนาจเจริญ - ลาบหมาน้อย
กาฬสินธุ์ - ตำเมี่ยงนาคู
มหาสารคาม - ลาบปูนา
กำแพงเพชร - บะหมี่ซากังราว
ชัยนาท - สังขยาหน้าควายลุย
นครนายก - ขนมข้าวกระยาคู
นครปฐม - ข้าวหลามบ๊ะจ่าง
นนทบุรี - ทอดมันหน่อกะลา
ปทุมธานี - ข้าวแช่รามัญ
อยุธยา - แสร้งว่ากุ้ง
นครสวรรค์ - ส้มตำไหลบัว
พิจิตร - ปลาเห็ดทอด
พิษณุโลก - ซี่โครงหมูแซ่บแห้ง
เพชรบูรณ์ - ข้าวลืมผัว / ไก่ย่างข้าวเบือ
สุโขทัย - น้ำพริกซอกไข่ / ข้าวเปิ๊บ
ลพบุรี - แกงมันนก
สระบุรี - ผัดหมี่ไทญวน
สิงห์บุรี - ปลาช่อนแม่ลา
สุพรรณบุรี - ปลาม้าแดดเดียว
อ่างทอง - ขนมเกสรลำเจียก
อุทัยธานี - ซาลาเปาไส้ปลาแรด
สมุทรปราการ - น้ำพริกปลาสลิด
สมุทรสงคราม - ปลาทูแม่กลอง
สมุทรสาคร - แกงส้มปูไข่ใบชะคราม
ชลบุรี - ปลาคกต้มเค็ม
ระยอง - แกงส้มผักกระชับ
จันทบุรี - ก๋วยเตี๋ยวหมูเลียง
ตราด - ยำหอยปากเป็ด
ฉะเชิงเทรา - บุหลันดั้นเมฆ
ปราจีนบุรี - ยำกระเฉดชะลูดน้ำ
สระแก้ว - เส้นหมี่หน้าหมู
ตาก - แกงมะแฮะ
กาญจนบุรี - แกงเห็ดโคน
ราชบุรี - กระเพราเต้าหู้ดำ
เพชรบุรี - ขนมจีนทอดมัน
ประจวบคีรีขันธ์ - หอยเสียบจิ้มมะละกอ
ชุมพร - แกงเหมงพร้าว
ระนอง - ยาวเย
สุราษฏร์ธานี - วายคั่วเกาะสมุย / ยำปลาเม็ง นาสาร 
นราธิวาส - ละแซ / นาซิดาแฆ
ปัตตานี - ข้าวยำน้ำบูดู / ไก่กอและ
ยะลา - วู่เกาเก๊า / ตะปะซูตง
พังงา - จอแลง / ลูกชกเชื่อม
สตูล - ชาชัก /  แกงตอแมะห์
ตรัง - หมี่หนำเหลี่ยว
ภูเก็ต - เป๋าฮื้อนึ่งซีอิ๊ว
พัทลุง - เต้าคั่ว / ข้าวส้ม
สงขลา - แกงเหลือง
นครศรีธรรมราช - ขนมจีนน้ำยาเส้นสด / มังคุดคัด
กระบี่ - หอยชักตีน
